13
################
# $    . #      ##
#      .    $$  ###
#   ####  $    #  ##
# #   .   #     ##  #
# #      @     $  . #
#   ####  $   . ##  #
#            ###  ##
######       .  .#
#            #####
## $.  $##$ $ .#
#  .#    #    #
###############