7
 #####
##.  ###
#  # $@#
#  # # #
# *  $.#
#    ###
######