6
######
#@*  ##
# $#  #
# $ . #
#.   ##
######