6
######
#   .#
#$$$@#
#. # #
#  . #
######