7
#######
#  .  #
# $ # ##
#.#$ $ #
#  .#@ #
#   #  #
########